MMMMMMMMMMMMMMMMMMMMMMMMMMMMMMMMM
M0000000000000000000000000000000M
M0900000000000000000000000000000M
MMMMMMMMMM00MMMMMMMMMMMMMMMMMMMMM
M000g0000000g000000g0000000g0000M
M0HHHHHHHHHHHHHH00g0000000g00000M
M0H000g00000000H000SSSSSSSSSSSSSM
M0H0000g0000g00H000S00000g000a00S
M0HHHHH000HHHHHH000S000g00000000S
M0g00000g0000000000S0g000SSSSSSSS
MMMMMMMMMMMMMM00000S00000S00g000M
M0000g0000000M00000S00000S000000M
M000000000000M00000S00g00S000000M
M000000000000M00000SSSS00S0000g0M
M0g0000g00000M0000g000000S00g000M
MMMMMMMM00MMMMM000MMMMMMMS000000M
M000g0000g000g0000g000000S00g000M
M0OOOOOOOOOOOOOOO00000000S000000M
M0O000000000g000O000g0000S000000M
M0O00000000000g0O00000000S000000M
M0OOOO000OOOOOOOO00000000S000000M
M000g000000g0000g00000g00S00g000M
M000g00000g0000g0000g000000g0000M
M0000000000000g00000g00000000000E
MMMMMMMMMMMMMMMMMMMMMMMMMMMMMMMMM
