MMMMMMMMMMMMMMMMMMMMMMMMMMMMMMMMM
M0000000000000000000000000000000M
M0900000000000000000000000000000M
MMMMMMMMMM00MMMMMMMMMMMMMMMMMMMMM
M000g0000000g000000g0000000g0000M
M0HHHHHHHHHHHHHH00g0000000g00000M
M0H000g00000000H000SSS0SSSSSSSSSM
M0H000000000g000000S000000000a00S
M0HHHHH000HHHHHH000S000g00000000S
M00000t000000000000S00000SSSSSSSS
MMMMMMMMMMMMMM00000j00000S00g000M
M0000g0000000M00000S00000j000000M
M000000000000j00000S00g00S000000M
M000000000000M00000SSSS00S0000g0M
M000000000000000000000t00S000000M
MMMMMMMM00MMMMM000MMMMMMMS000000M
M000g00000000000000000000S000000M
M0OOOOOOOOOOOOOOO00000000S000000M
M0O000000t000000O000000000000000M
M0O00000000000g0O00000000S000000M
M0OOOO000OOOOOOOO00000000S000000M
M000000000000000j000000000000000M
M000g000000000000000000000000000M
M0000000000000g00000t00000000000E
MMMMMMMMMMMMMMMMMMMMMMMMMMMMMMMMM
