22222222222222222222222222222222222222
2333333333333333333333333333333333332
2311111111111113111111111111131111132
2310000000000003000000000000030000032
2310000J0000000300000T0000000300M0032
2310000000000003000000000000030000032
2311111111110003000111111111130111132
2300000000010003000100000000100000032
2300000H000100030001000G000G100000032
2300000000010000000100000000100000032
2311111111110111111100000000100111132
2300000000000000000000000000000000032
230000000000000000000000000M000000000E2
2300000000000000000000000000000000032
2311111A11111111111100000011111111132
2300000000000000000100000010000000032
2300000000000J0000010000001000T000032
2300000000000000000100000010000000032
2311111111111111111100000011111111132
2390000000000000000000000000000000032
23000000000M000000000000000000000J032
2300000000000000000000000000000000032
2311111111111111111111111111111111132
2333333333333333333333333333333333332
22222222222222222222222222222222222222