22222222222222222222222222222222222222
2333333333333333333333333333333333332
2311111111111113111111111111131111132
231T00000000000300J0011100000300T0032
2310000J00000003000001T100000300M0032
23100M0011G10003000000000000030000032
2311111111110003000111101111130111132
23000000000100030001000K0000100000032
2300000H000100030001000G000G100T00032
230000J00001000000010000M000100000032
2311111111110111111100000000100111132
23000M0010000000J0000001110000000M032
23000000100K000000000001T100M000000E2
230J0000100000T00000M000000000T000032
2311111A11111111111100000011111111132
23000T0000M00011110100J00010000M00032
23000000K0000J1001010000001000T000032
230K00000011G0100101000K00100K000J032
2311111111111111111100000011111111132
2390000T0010000J0000000M0010000T00032
23000000001M000000K00011001G00000J032
2300J00000100T0000000J00001M000000032
2311111111111111111111111111111111132
2333333333333333333333333333333333332
22222222222222222222222222222222222222