22222222222222222222222222222222222222
2333333333333333333333333333333333332
231111111111111311111111111113111J132
231T00000000000300J001110000030000032
23100T00J0000003000001T1J0000300M0032
23100M0011G10003000000000000030000032
2311111111110003000111101111130111132
230j0000000100030001000K00001000j0032
23000000H0001000300T1000G000G100T00032
230t00J00001000000010000M000100000032
23111111111101111111000000001J0111132
23000M0010000000J0000001110000000M032
230t0000100K000000000001T100M000000E2
230J00j0100000T00000M000000000T000032
2311111A11111111111100000011111111132
23000T0000M000111j0100J00010000M00032
23000j00K0000J100101000j001000T000032
230K00000011G0100101000K00100K000J032
2311111111111111111100000011111111132
23900t0T0010000J0000000M0010000T0j032
23000000001M00j000K00011001G00000J032
2300J00t00100T0000000J00t01M00t000032
2311111111111111111111111111111111132
2333333333333333333333333333333333332
22222222222222222222222222222222222222