11111111111111111111111111111111111111
10000000000000000000000000000000000001
10000000000000000000000000000000000001
10000C0000000000000000000000000J00001
10000000000000000000000000000000000001
10000000000T0000000000000T000000000001
10000000000000000000000000000000000001
1000000000000000H000000000000000000001
10000000000000000000000000000000000001
10000M000000000000000000000000M000001
10000000000000000000000000000000000001
10000000000000000000000000000000000001
10000000000G0000C0000000000G0000000001
10000000000000000000000000000000000001
10000000000000000000000000000000000001
10000000000000000090000000000000000001
10000000000000000000000000000000000001
10000000000000000000000000000000000001
10000000000000000A00000000000000000001
10000000000000000000000000000000000001
10000J0000T0000000000000M000C000000001
10000000000000000000000000000000000001
10000000000000000000000000000000000001
10000000000000000000000000000000G00001
10000000000000000000000000000000000001
10000000000000000000000000000000000001
10000000000000000000000000000000000001
100000000000000000B0000000000000000001
10000000000000000000000000000000000001
11111111111111111111111111111111111111
