1111111111111111111111111111111111111111
190h0010000000000010C000a00000t0000000C1
100A00100j00T000001000000000000000g00001
100000100000000m00111m100011111111111011
11101111111110000000000000j0000000001001
10000000T000100000000000000000T000001001
100g000000001001111111M1111110000m001001
1111111011111001000000000000111011111001
10000j000000000100t00j000000001010000001
1000000011111111000000B000m00010100m0001
1000000010000a0100000000000000101000j001
100m0000100h00011110M0000M01111010000g01
11111m1110000000000000000000000011110111
10000000111M1111111110111111111110000001
100T000000000000j00010j0000000001000T001
1000000m00000000000010100g00000010000001
111011111110111j11111011111m111110111111
1000I00100000000000000000000000m1000A0h1
1h00a001000m000jT00j000T000g0000100I0001
1110111100000000011111111111100011101111
1000000100t000j00100000C00001000100m0001
100m000100000g000100T000000010a0100g0001
10000001000h00000100000a0000100010000001
1C0a00010m00000001000000j0001000100A0001
1111111111111111111111111111111111111111
